alle	alle
allem	alle
allen	alle
aller	alle
alles	alle
andere	andere
anderem	andere
anderen	andere
anderer	andere
anderes	andere
anderm	andere
andern	andere
andre	andere
andrem	andere
andren	andere
andrer	andere
andres	andere
beide	beide
beidem	beide
beiden	beide
beider	beide
beides	beide
das	d-
dein	dein
deine	dein
deinem	dein
deinen	dein
deiner	dein
deines	dein
deinige	deinig
deinigen	deinig
deins	dein
dem	d-
den	d-
der	d-
derjenige	derjenige
derjenigen	derjenige
derselbe	derselbe
derselben	derselbe
derselbige	derselbige
derselbigen	derselbige
des	d-
die	d-
diejenige	diejenige
diejenigen	diejenige
dies	diese
diese	diese
dieselbe	dieselbe
dieselben	dieselbe
diesem	diese
diesen	diese
dieser	diese
dieses	diese
ebendies	ebendiese
ebendiese	ebendiese
ebendiesem	ebendiese
ebendiesen	ebendiese
ebendieser	ebendiese
ebendieses	ebendiese
ebenjene	ebenjene
ebenjenem	ebenjene
ebenjenen	ebenjene
ebenjener	ebenjene
ebenjenes	ebenjene
ein	ein
eine	ein
einem	ein
einen	ein
einer	ein
eines	ein
einige	einige
einigem	einige
einigen	einige
einiger	einige
einiges	einige
erstere	erstere
ersterem	erstere
ersteren	erstere
ersterer	erstere
ersteres	erstere
etliche	etliche
etlichem	etliche
etlichen	etliche
etlicher	etliche
etliches	etliche
etwelche	etwelche
etwelchem	etwelche
etwelchen	etwelche
etwelcher	etwelche
etwelches	etwelche
euer	euer
euere	euer
euerem	euer
eueren	euer
euerer	euer
eueres	euer
euerm	euer
euern	euer
euers	euer
eure	euer
eurem	euer
euren	euer
eurer	euer
eures	euer
eurige	eurige
eurigen	eurige
ihr	ihr
ihre	ihr
ihrem	ihr
ihren	ihr
ihrer	ihr
ihres	ihr
ihrige	ihrige
ihrigen	ihrige
irgendein	irgendein
irgendeine	irgendein
irgendeinem	irgendein
irgendeinen	irgendein
irgendeiner	irgendein
irgendeines	irgendein
irgendeins	irgendein
irgendwelche	irgendwelche
irgendwelchen	irgendwelche
irgendwelcher	irgendwelche
jede	jede
jedem	jede
jeden	jede
jeder	jede
jedes	jede
jedwede	jedwede
jedwedem	jedwede
jedweden	jedwede
jedweder	jedwede
jedwedes	jedwede
jegliche	jegliche
jeglichem	jegliche
jeglichen	jegliche
jeglicher	jegliche
jegliches	jegliche
jene	jene
jenem	jene
jenen	jene
jener	jene
jenes	jene
kein	kein
keine	kein
keinem	kein
keinen	kein
keiner	kein
keines	kein
keins	kein
manch	manch
manche	manch
manchem	manch
manchen	manch
mancher	manch
manches	manch
mehrere	mehrere
mehreren	mehrere
mehrerer	mehrere
mein	mein
meine	mein
meinem	mein
meinen	mein
meiner	mein
meines	mein
meinige	meinige
meinigen	meinige
meins	mein
sämtliche	sämtliche
sämtlichem	sämtliche
sämtlichen	sämtliche
sämtlicher	sämtliche
sämtliches	sämtliche
sein	seine
seine	seine
seinem	seine
seinen	seine
seiner	seine
seines	seine
seinige	seinige
seinigen	seinige
solch	solche
solche	solche
solchem	solche
solchen	solche
solcher	solche
solches	solche
soviel	soviel
soviele	soviel
sovielem	soviel
sovielen	soviel
sovieler	soviel
sovieles	soviel
unser	unser
unsere	unser
unsereinem	unsereiner
unsereinen	unsereiner
unsereiner	unsereiner
unsereines	unsereiner
unsereins	unsereiner
unserem	unser
unseren	unser
unserer	unser
unseres	unser
unserige	unsrige
unserigen	unsrige
unserm	unser
unsern	unser
unsers	unser
unsre	unser
unsrem	unser
unsren	unser
unsrer	unser
unsres	unser
unsrige	unsrige
unsrigem	unsrige
unsrigen	unsrige
viel	viel
viele	viel
vielem	viel
vieler	viel
vieles	viel
welch	welch
welche	welch
welchem	welch
welchen	welch
welcher	welch
welches	welch
wenig	wenig
wenige	wenig
wenigem	wenig
wenigen	wenig
weniger	wenig
weniges	wenig
wenigste	wenigste
wenigsten	wenigste
wenigstes	wenigste
zuviel	zuviel
zuviele	zuviel
zuvielen	zuviel
zuvieler	zuviel
zuwenig	zuwenig
zuwenige	zuwenig
